11111
1CPE1
11111
11011
11011
10001
11111